え、えっと……こ、これ洗えてるんですか……？　綺麗になる気があんまりしませんけど……ひっ……く、くすぐったいです、これっ……	嗯，那个……这个，这个能洗吗……？虽然不怎么想变漂亮……嗯……这个……
ん、んぅっ……腕しっかり伸ばしてもらえますか？　んぅ、変ですよこんなのっ……私にこんなことさせて、楽しんでるご主人様も、おかしいです……	嗯，嗯……可以把胳膊伸直吗？嗯，很奇怪啊这样的东西……让我做这样的事，享受的主人也很奇怪……
ご主人様のが詳しいですよね……？　こんな感じで合ってますか……？　一応やってますけど、あんまり理解できそうにないです、私……	您对主人的情况很了解吧……？是这样的感觉吗……？虽然做了一次，但是好像不太能理解，我……
ん、んっ！　もう綺麗になりましたよねっ！？　んんぅ、いつまでこれ、続ければいいんですか？　ひゃあっ、う、うぅ……擦れて、私っ……！	嗯、嗯！已经变漂亮了吧！？嗯，这个要持续到什么时候？啊，啊，嗯……擦掉我……！
こんな風に腕を洗うなんて……私が変態みたいじゃないですか……もう、ご主人様がしてほしいからしてるだけですからね……？	竟然这样洗手……我不是变态吗……已经只是因为主人想要才做的吧……？
う、くぅっ……洗えてない気がするんですけど……ご主人様の腕で、その……いやらしいことしてるだけみたいで……うぅ、ち、違いますっ、私はそんなこと考えてなんかいませんからっ……	呜、唔……感觉没洗好……用主人的手臂，那个……好像只是做了恶心的事情……嗯，是的，不是的，因为我没有考虑过那样的事情……
はぁ、あっ……はぁ、変な感じです、ご主人様っ……だ、だってご主人様の腕何度も擦れるから……んぅぅ、もう、じっとしててくださいっ……	啊，啊……啊，感觉很奇怪，主人……但是，因为主人的手臂会擦好几次……嗯，请不要动了……
んひゃぅっ！　ご主人様ぁっ、もうやめてもいいですかっ？　だ、だって、んんぅ、腕汚れちゃ……ち、ちがくてっ！　しょうがないじゃないですかっ！	喵喵！主人啊，已经可以停止了吗？但是，因为，嗯，手臂脏了……智、智学！没办法啦！
これって洗うって言うより、エッチな行為ですよね……？　普通にするならタオルで優しく洗ってあげられますよ？　私……	这与其说是洗洗，不如说是色情行为吧……？普通的话可以用毛巾温柔地洗哦？我……
んんぅ、もっと強く擦った方がいいんでしょうか……？　恥ずかしいですけど、ご主人様がそういうなら……ん、んっ、気持ちいいですか？	嗯，再用力一点比较好吧……？虽然很不好意思，但是如果主人那样的话……嗯，嗯，心情好吗？
はぁ、はっ、くぅぅ！　ご主人様の腕で私、落ち着かなくなっちゃって……はぁ、あっ、もういいですよね？　これ以上は、私ダメですっ！	哈、哈、呜！主人的手臂让我无法平静……啊，啊，已经可以了吧？再这样下去，我就不行了！
私にこんなエッチなことさせて、ご主人様興奮しちゃってるんですよね……？　もう、洗ってるだけなのに、ご主人様はいやらしいですね、本当……	让我做这种色情的事情，主人很兴奋吧……？只是洗了一下，主人却很讨厌，真的……
どう、ですかっ？　私のアソコで、洗われて……気持ちいいですか？　ご主人様っ……満足するまでいっぱい擦ってあげますからね……	怎么样，这样啊？被我的那个家伙洗了……舒服吗？主人……在满足之前我会帮你擦很多的……
ん、あっ、腕強く擦ると、んん！　アソコに強く当たって、あっ、んぅ！　はぁ、はぁっ、いっぱいぬるぬる滑っちゃって、ひうっ！　もぅっ、ご主人様っ！	嗯，啊，手臂用力一擦，嗯！用力打到那个人，啊，呜！哈，哈，滑了很多滑腻的，好烫！嗯，主人！
ん、しょっ……どうですか？　ご主人様の腕、私のふとももでむにゅって挟んで……ん、んっ、いっぱい擦れちゃってますね……？　はぁ、あっ……	嗯，嗯……怎么样？主人的手臂，在我的大腿里紧紧地夹着……嗯，嗯，擦了很多呢……？啊，啊……
ひゃ、んっ……！　はぁ、あっ、洗ってる私まで、ドキドキしちゃって……んぅ、すごくエッチですよね、こうやってしてるのっ……なのに、何ででしょうか、私、おかしくてっ……	哎、哎……！哈，啊，连正在洗的我都心跳不已……嗯，真的很H呢，就是这样做的……但是，为什么呢，我觉得很奇怪……
あ、あっ、くぅ、んぅっ！　ご主人様ぁっ、私、私っ！　んんぅ！　ダメぇっ、洗ってるだけで、気持ちくてっ、動くの、止まらなくなっちゃうっ！	啊，啊，嗯，嗯！主人，我，我！恩恩恩！不行啊，光是洗一下就觉得恶心，动起来就停不下来了！
ん、んっ、ぁっ……ご主人様の腕、男の人の腕って感じしますね……ん、んっ……いっぱい、綺麗になるように……擦りますから……	嗯，嗯，啊……感觉到主人的手臂是男人的手臂……嗯，嗯……为了变得更加美丽……因为会擦伤……
んふっ、あっ……びっくりしますから、動いちゃダメですよ……？　私が洗ってるんですからっ……んんう、あっ、ひぁっ……こうやって、強く擦って……	嗯哼，啊……因为很吃惊，所以不能动哦……？因为我在洗……嗯，啊，啊……这样强烈地摩擦着……
んぅっ、ご主人様ぁ……お汁出て、ぬるぬるしちゃいますぅ……はぁ、くぅ、ご主人様も興奮しちゃってますよね……？　触ってないのにびくびくしてますよ……	嗯，主人……出了汤，变得粘糊糊的……哈，呃，主人也很兴奋吧……？明明没有碰却提心吊胆的……
くぅっ、んっ……はぁ、はぁっ……泡がぬるぬるのねばぁって、なっちゃってますぅ……はぁ、んぅっ……洗ったのにまた汚れちゃっ……くぅ、んっ、もっと擦りますからっ……！	嗯，嗯……哈、哈……泡沫是温的，变成了……啊，嗯……洗了又弄脏了……嗯，嗯，我会再擦一点的……！
いっぱいごしごししちゃいますね……？　ん、んっ……太ももでご主人様の腕、挟んでぇ……はぁ、あっん……おまんこ、擦りつけてっ……くぅっん……♪	过了很多日子呢……？嗯，嗯……用大腿夹着主人的手臂……啊，啊……小穴，蹭破了……嗯……♪
ひゃっ、あっん……洗ってるだけで私、気持ちよくなっちゃうなんて……いけないですよね……？　ん、ひゃっ、ご主人様、許してくれますかぁ……？　んんっ……	哎呀，啊……光是洗一下我就觉得很舒服……不可以吧……？嗯，喵，主人，能原谅我吗……？嗯……
はっ、はふっ、んぅぅ！　ご主人様ぁ、おまんこ、とろとろなのわかりますかぁ……？　腕でいっぱい擦れて、オナニーしてるみたいですっ、はぁ、あっん、もっとしたいっ……！	哈、哈、嗯！主人啊，你知道小穴是粘稠的吗……？用手臂擦了很多，好像在自慰呢，哈，啊，想再多做一点……！
