んぅ、っちゅ……いくら自分の体液といっても、こんなもの、汚いだろう……ん、ちゅ、ぅう……何より、気持ち悪いぞ……	嗯，chu……就算是自己的体液，这种东西也很脏吧……嗯，嗯，嗯……比什么都恶心……
れる、ん、ちゅ……自分で、自分のアソコを舐めさせられている気分だ……れろ、んんぅ……ご主人様だって、自分のものを舐めたくないだろう……？	嗯，中……感觉自己好像在舔自己的阴部……嗯，嗯……就算是主人，也不想舔自己的东西吧……？
っちゅぱ、んんぅ……っ、改めて見ると、やはり大きすぎるぞ……んく、ちゅぷ……！　こんなものを、挿れさせられていたなんて……	小鸟、恩……嗯，再看一下，果然太大了……嗯，中浦……！居然让我插了这样的东西……
こんなものを舐めさせられるのも、それがこんなに濡れているのも……ん、ちゅ、れるぅ……！　どっちも恥ずかしくて、変になってしまそうだ……	让我舔舐这样的东西，也让我如此濡湿……嗯，中，中……！两个都不好意思，好像变奇怪了……
っちゅ、れろ……うぅっ、こんな下品な姿、恋人に見られるのが一番恥ずかしい……んぅ、ちゅ、れるぅ……	嗯，那个……呃，这样粗俗的样子，被恋人看到最害羞……嗯，中，嗯……
んっちゅ、ちゅぱ……自分の愛液の味なんて、知りたくなかったことだな……んっちゅ、ぅう……頭の奥が痺れるみたいだ……	嗯，中穗……自己的爱液味道，真是不想知道啊……嗯，嗯……头的深处好像麻痹了……
れぅ、んちゅ……！　こんなの、舐めているだけでも疲れてしまいそうだ……んく、ちゅう……！　本当にこれが、私の中に入っていたのか……？	哎、啾……！这种东西，光是舔一下就已经很累了……哼、中……！这个真的进入了我的体内吗……？
っちゅぴ、んんちゅ……！　せっかく舐めるなら、こんなオモチャより、ご主人様のものの方がいいな……ん、ちゅぱ、んん……っ	嗯，嗯……！好不容易才舔的话，比起这种玩具，还是主人的东西好啊……嗯、ちゅぱ、ん……嗯
れろ、ちゅぱ……っ、ご主人様は、どこまで私を苛めれば気が済むんだ……んっちゅ、れるぅ……こんな、恥ずかしくて、屈辱的なことまでさせて……	嗯，中穗……啊，主人，你到底要欺负我到什么地步啊……嗯……让我做这种、害羞、屈辱的事情……
ちゅ、っん、ちゅぱ……っ、うぅ、私のアソコは、こんなものが入ってしまうくらい、拡がってしまったということか……？	中、中、中……呜、呜、我的那里、竟然扩展到了可以容纳这样的东西的程度……？
ご主人様のを、掃除しているようなものだろうか、んちゅ、ん、っふぅ……！　そう思えば少しは……少しだけは、平気かもしれない……	像是在打扫主人的东西吗，嗯，嗯……！这么想的话……稍微有点，也许没关系……
れろ、ちゅ、ちゅぅ……まさか、舐めた後にまた挿れさせて……っれる、んちゅぅ……何度も舐めさせるつもりじゃないだろうな……？	来、chu、chu……难道，舔过后又让它插上……嗯，嗯……不打算让他多次舔吧……？
んっちゅ、ちゅぱ……！　こんなに大きなものが入っていたと思うと、んちゅ、れる……っ、お腹の奥が、むず痒くなってしまう……	嗯，中穗……！一想到里面放了这么大的东西，嗯，嗯，嗯……啊，肚子里痒痒的……
んんっ、自分の愛液を舐めて、興奮してしまうなんて、れる、んっ、ちゅ……！　そんなはずがないだろう、っれろ、ちゅ、っんちゅぅ！	哼，舔着自己的爱液，兴奋起来，呜，啾……！那怎么可能呢，嗯，嗯！
っんぁ、ちゅ、れる……あまり見ないでくれ、ご主人様、んちゅ、んんぅ……変な気持ちが、湧いてしまいそうなんだ……	嗯，中，被……请不要看太多，主人，嗯，嗯……感觉会涌出奇怪的心情……
ちゅぱ、れるぅ……っ、アソコがすーすーして、妙な感じだ……んく、っちゅ、ちゅぅ……今だけでも、ご主人様のを……ダメか？	喂，是吗……啊，那个很厉害，感觉很奇怪……嗯，嗯，嗯，嗯……即使只有现在，也要把主人的……不行吗？
んちゅ、んんぅ……！　恥ずかしいのに、舌が止まらないんだ、っちゅ、れるぅ！　うぅっ、それで興奮しているご主人様だって、同罪だぞ……っ？	嗯，嗯……！明明很害羞，舌头却停不下来，呜，呜！嗯，因此而兴奋的主人也是同罪啊……嗯？
んぐっ、ちゅぷ……こんな、太いのを挿れさせて、舐めさせるなんて……ふぁ、んっ、ご主人様は、エッチだな……ん、ちゅぷ、れるぅ……	哼哼，小鸟……让这么粗的插进去舔……嗯，嗯，主人，真是好色啊……嗯、ちゅぷ、れるう……
んっ、私のあそこの味がして……ちゅぷ、こんな命令、本当は嫌なはなずなんだが……ご主人様の変態って、伝染るのか？　ちゅむ、ん♪	嗯，我那儿的味道……小鸟，这样的命令，其实并不是讨厌的……主人的变态会传染吗？嗯，嗯♪
ちゅぷっ、うぅ、自分の中にはいってたオモチャ舐めてるだけなのに、ふっぁ、あそこが濡れて……んぅ、また、挿れたくなってくる……	呜，呜，我只是在舔装在自己身上的玩具而已，啊，那边湿了……嗯，又想被插上了……
ふぁ、大きくて、自分でしてるのに、犯されてるみたいで……ふぁ、ちゅむ、頭が、これしか考えられなくなる……うぅ、ご主人様のせいだぞ……	啊，太大了，明明是自己做的，好像被侵犯了……嗯，中，头，只能这么想了……呜，都是主人的错……
んむ、ちゅぷっ、ご主人様のおちんちんを想像して……綺麗に隅々までお掃除するから……んぅ、下に本物が欲しいな、ご主人様……	恩，chuppu，想象一下主人的吝啬鬼……会漂亮地打扫到各个角落……嗯，下面真想要，主人……
れる、ぢゅぷぷっ、こんな太いの挿れてたのに、もっと、欲しくなるなんて……私は変態なのかな、今も、自分のエッチなのを舐めて興奮してるんだ……ふふっ	小胖子，小胖子，明明插了这么粗的，居然还想要……我是变态吗，现在也是，舔着自己的H很兴奋……呵呵呵
ぢゅぷ、ちゅぶっ！　オモチャより、ご主人様のおちんちんを舐めたいよ……精液で汚れたおちんちん、綺麗に舐め取ってあげるのに……	噗哼，加油！比起玩具，更想舔你的主人……被精液弄脏了的肉棒，明明能好好地舔干净的……
