ご、ご主人様ぁ……んぅ、あぁっ……こんなにくっついてするの、うくぅ……恥ずかしいです……	喂，主人……嗯，啊……这么粘在一起，好郁闷……不好意思……
はぁ、あぁんっ……ご、ご主人様のおっきくてぇ、ぁああっ……苦しいくらい、ですっ……	哈、啊啊……喂，主人太大了，啊啊啊啊……好痛苦啊……
あっあっ、そんな、激しいです、んんっ、ご主人様ぁ！　あたし、くっついて……はぁ、はひっ……んんっ……ご主人様ぁっ……	啊，那种，太激烈了，哼，主人！我，粘着……哈、哈哈……嗯……主人啊……
あ、あたしもうだめです、ご主人様ぁっ……！　こんなにぎゅってしてたら、ぁああっ！？　くぅううううんっ……！	啊，我已经不行了，主人啊……！这么紧的话、啊啊啊！？呜呜呜呜呜呜……！
あぁ、好きぃ……ご主人様ぁ、んぅ、大好きですぅっ……もっともっと、こうしてくっついていたいです、あぁ……	啊，好喜欢……主人啊，恩，非常喜欢……想要更加、更加地、这样跟着、啊……
ご、ご主人様がしたいなら……はぁ……はうっ……いっぱい……んっ……はううっ……あたし……えっち……すぎですぅっ……	如果主人想做的话……哈……哈……满满的……嗯……呜呜……我……诶……太过分了……
んぅ、このまま、ずっとくっついたままでぇ……！　ご主人様っ、ご主人様ぁ……大好き、ですぅ、んんっ！	嗯，就这样，一直粘在一起……！主人，主人……最喜欢了，嗯，恩！
ご、ご主人様……あぁ、ご主人様の事、誰よりも、ぁああっ、はぁ、はううっ、も、もうっ……なにも、かんがえられなく、あああっ！	主人……啊，主人大人的事情，比任何人都……啊啊啊，哈，呜呜，呜，已经……什么都无法想象，啊啊！
ご主人様ぁ……どうですか、あたしの中は……？　んんぅ、こんなに硬くしてぇ……興奮、してるんですね、ぁああっ……	主人啊……怎么样，我的内心……？嗯，这么硬啊……好兴奋啊，啊啊……
んぅ、こんなにくっついてると、ドキドキしちゃいますね……ぁああっ……！　はぁ、はうっ……はずかし……ですぅっ……	嗯，这样粘在一起的话，会心跳加速呢……啊啊啊啊……！哈、哈……不好意思……那么……
はぁ、はううっ、えっちなこえ……あ、あたしぃ、エッチな声出しながらもうイっちゃいそうですぅ……！　	哈、哈、哼、哼……啊，我啊，一边发出H的声音一边快要走了的那样……！　
えへへっ……こうしてぎゅってしながらするの、いいですよねっ♪　いっぱい気持ち良くなりましょうね、ご主人様ぁ……	嘿嘿……就这样紧紧地握着，真好啊♪让心情变好吧，主人啊……
んんぅ、こんなに激しくしてぇ、えへへっ♪　あたしの中、ぐちゅぐちゅってエッチな音立ててますよ、ご主人様ぁっ……！	恩，这么激烈啊，嘿嘿♪我的里面，发出了咕嘟咕嘟的色情的声音哦，主人啊……！
ほらぁ、ご主人様、イって下さいねっ、んっ！　ちゃんと最後までぇ、あたしも、ぎゅってしますからぁ！　一緒に、あたしもっ！	喂，主人，喂，喂！好好地到最后，我也紧紧地握住了！一起，我要！
あぁ、好きぃ……大好きですぅ、ご主人様ぁ……あっ、いっぱいいっぱい、くっついていたいです、えへへっ……♪	啊，好喜欢……非常喜欢，主人……啊，想粘得太多，嘿嘿……♪
もっと、もっとぉ……あたしの事、愛して欲しいですぅ、んんぅ！　ご主人様にぃ、好きって欲しいです、たくさんっ……！	更加、更加……我希望你能爱我，嗯！希望主人，喜欢，很多……！
あぁ、一緒にぃ、一緒にイキたいです、ご主人様ぁ！　好きっ、大好きですぅ、んぅ、ずっと、ぎゅってしてますからぁ、ぁああっ！	啊，想在一起，一起活下去，主人！喜欢，非常喜欢，嗯，一直，紧紧地握着，啊啊！
はぁあ、んぅ……ご主人様のおちんちん、あたしの奥まで、あぁ、はぁん……届いてるから、んん……すごくおっきくて、あっ、ご主人様……	啊，嗯……主人的爷爷，到我的深处，啊，哈……因为收到了，嗯……太大了，啊，主人……
あたしのおまんこ、どうですかぁ……？　はぁ、んん……こうしてくっつきながら、おちんちん感じると、はう……あたしドキドキして、んぅうっ……	我的女阴，怎样啊……？嗯，嗯……像这样粘在一起，感觉很稳重，哈哈……我七上八下的，嗯……
あたしの、エッチな声聞いて、んん……！　ご主人様、余計に感じちゃってるのかな、はう……それなら、もっと……あたしの声聞いて、ぁああ……！	听我的，色情的声音，嗯……！主人，是不是多余的感觉呢，哈哈……那样的话，就更加……听我的声音，啊啊……！
おまんこ熱い、んぅ、あっ！　ご主人様にも伝わってますよね、はぁはぁ、おちんちんこんなに締め付けちゃって……ああ、んぅうう……！	你好烫，嗯，啊！也传达给主人了哦，哈哈，小鸡鸡这么紧……啊、嗯……！
んぅ、ご主人様……ほら、こんなにぎゅってしてるんだから……えへへ、あたしのおまんこもっとぐちゅぐちゅにして、可愛がって、あぁん……	嗯，主人……你看，原来是这么紧的……嘿嘿，我的猫咪要更加牢骚一点，疼爱，啊啊……
おちんちんこんなにおっきくされちゃうと、おまんこ拡がったまま戻らなくなっちゃう、えへへ……♪　いっぱいぎゅってするから、精液出して……？	小鸡鸡这样大声说话的话，你扩张着就回不去了，嘿嘿……♪因为紧紧地握着，把精液拿出来……？
イク、イっちゃう、えへへ♪　あたしの感じてる声……聞きながら、んぅ、ご主人様のおちんちんビクビク震えてるのぉ、！　あっあっ、一緒にイこ、このままぎゅって、あぁん！	イク、イっちゃう、えへへ♪我所感受到的声音……一边听，恩，主人的chinchibiku一边颤抖着，！啊，一起来吧，就这样紧紧地，啊啊！
