んく……ん、ちゅ……ご主人様の……こんなに大きくなるのか……？　んちゅ、んん……これに奉仕するのは、大変だぞ……	嗯……嗯、ちゅ……主人的……会变得这么大吗……？嗯，嗯……为这个服务可不容易啊……
ちゅ、っんむ……これで、気持ちよくなれている、だろうか……？　れる、んちゅ……少し、心配だな……ちゅぷ、っちゅ……	嗯，嗯……这样的话，心情会变好吗……？嗯，中……有点担心啊……中，中…
んちゅ、ん、ぅ……こんな風に、ご主人様に奉仕するのは……んちゅ、んんむ……流石に少し、恥ずかしいな……	嗯，嗯，嗯……像这样为主人服务的是……嗯，嗯……果然还是有点害羞啊……
んぐ、っぢゅぷ……これだけ、大きいと、んんぅ……、苦しくなってしまうな……ん、ちゅ、ぢゅぷぅ……	嗯，呜呜……这么大的话，嗯……不要痛苦了……嗯、中、小呼……
んちゅ、ぢゅぱ……、ご主人様、きつかったり、痛かったりしないだろうか……？　ちゅぷ、んんっ……上手くできているか……？	嗯，是啊……主人，你会不会觉得累或者痛……？嗯，嗯……做得好吗……？
れる、っぢゅるぅ……もっと激しい方が気持ちいいだろうか……？　ん、っちゅ、じゅるる……！　痛くならないか……？	啊，是啊……再激烈一点会舒服吗……？嗯，中，珠露露……！不疼吗……？
んちゅっ、じゅぷ……、ご奉仕しないと、いけないのに、っんちゅ、ぢゅるる……！　ご主人様の臭いで、頭が……くらくらしてしまう……	嗯，遵命……不为他服务是不行的，嗯，嗯，嗯……！因为主人的臭味，头脑……头晕……
んく、っちゅ、ぢゅぱ……！　口の中で、ご主人様のが暴れて、んんぅ……！　奉仕できなくなってしまうぞ……んく、ぢゅるぅ……！	嗯，是的，是的……！在嘴里，主人的发狂了，嗯……！不能为你服务了……嗯，是啊……！
ご主人様の、苦いのが垂れてきて、っんちゅ、じゅぷぅ……！　口の中が、いっぱいになりそうだ、っん、ぢゅぷっ、じゅるぅ！	主人的苦滴下来了，嗯，呜呜……！嘴里快撑满了，嗯，噗，好嘞！
ぢゅぱ、ぢゅるる！　ご主人様に、ご奉仕してるだけで、んちゅ、っじゅぷぅ！　私の方が、ドキドキしてしまう、っんぐ、んぢゅぅ！	真是的，真是的！我只是为主人服务而已，嗯，谢谢！我会更加心动的，嗯，嗯！
れるっ、じゅるうぅ！　ご主人様の、口の中で……っんぐ、じゅぶ、ぢゅるる！　このまま、私の奉仕で、出してくれるのか……？	我、我知道了！在主人的嘴里……唔，呜，呜，呜！就这样，为了我的服务，会给我拿出来吗……？
ん、っちゅ、ちゅぱ……ご主人様は、そのまま動かなくていいからな？　んちゅ、れる……私に、任せておいてくれ……！	嗯、ちゅ、ちゅぱ……主人就那样不动也可以吗？嗯，嗯，嗯……交给我吧……！
ちゅぷ、んちゅっ……ご主人様の、こんなに熱くなって……れる、ちゅぷ……私の奉仕で、興奮してくれているんだな……？	中，中……主人，变得这么热……被……是因为我的服务而兴奋的吧……？
んっ、ちゅ、じゅぷっ……そんなに、じっと見つめられると……っんちゅ、んんぐ……流石に私も恥ずかしいぞ……？	嗯，中，小珠……那样盯着看的话……嗯，嗯，嗯……果然我也很害羞啊……？
んぐっ、じゅぶぅ……！　いつもより、大きくなっていないか……？　んぢゅ、んんぅ……、少し、苦しいくらいだ……	嗯，好嘞……！没有比平时更大吗……？嗯，嗯……、有点痛苦……
れる、んじゅるぅ……、ご主人様は、もっと激しい方が好き、だったな？　んちゅ、ぢゅるる……！　ちゃんと、その通りに気持ちよくしてみせるぞ……	嗯，嗯，嗯……主人是不是更喜欢激烈一点的呢？嗯，是的……！我会好好地按照你说的那样让你心情舒畅的……
ご主人様の、びくびく震えて……ん、ぢゅぷ、じゅるぅ……！　気持ちよさそうに、反応してくれるから、奉仕し甲斐があるな……んちゅ、じゅぶぅ……！	主人的颤抖……嗯，呜，呜……！感觉很舒服，因为会有反应，所以很有服务的价值……嗯，你好……！
ぢゅぷ、じゅるぅう！　ご主人様の、先走りが出てきたな、んちゅ、じゅぶぅ！　もうそろそろ、限界か？　ぢゅるる、じゅぱ！	呼，好嘞！主人，刚才跑出来了啊，嗯，你好！已经差不多到极限了吗？咻咻，啾啾！
ご主人様が、気持ちよくなってくれるたびに、ぢゅる、んっ、じゅぷぅ！　私も、身体が熱くなってくるよ、んちゅ、ぢゅるぅう！	每次主人心情变好的时候，我都会叫“小咕”、“小咕”、“小咕”！我的身体也会变热的哦，嗯，呜哇！
イきたい時は、我慢しないでくれ、っんちゅ、じゅるる！　私も、その方が嬉しいからな、っぢゅぷ、んちゅ、じゅぶうぅ！	想玩的时候，请不要忍耐，嗯，珠露露！我也觉得那样会更开心的，啾，啾，啾！
ちゅぱ、ん、ちゅ……強くすると、やりすぎてしまう気がして……んく、っちゅ、ちゅぷ……それでもいいだろうか……？	中、中、中…如果太强的话，感觉会做过头……嗯，中，中……那样也可以吗……？
んちゅ、っんく……ご主人様、もっと大きくできるんじゃないのか？　っちゅ、ん、っれう……もっと激しくしないと、足りないということか……？	嗯，嗯……主人，不是可以做得更大吗？嗯，嗯，嗯……不更加激烈的话，是不够的吗……？
っちゅぱ、れるぅ……こんなところを咥えるなんて、恥ずかしいに決まっているだろう、んちゅ、じゅるるっ……ただ少し、夢中になるだけだ……	嗯，嗯……叼到这样的地方，肯定会很害羞吧，嗯，珠露露……只是有点着迷而已……
ご主人様も、気持ちいいんだな？　んぁ、っんちゅぅ……！　口の中で、こんなにびくびく震えてくれるんだから、んっちゅ、じゅぷぅ……！	主人也很舒服吧？嗯，嗯……！因为在口中，你会这么战战兢兢地颤抖，嗯，呜……！
ここから、濃いのがたくさん出てくるんだな、じゅぶ、んっ、ぢゅぱ！　想像しただけで、唾液が溢れてくる、っん、じゅぱ、ぢゅるうっ！　	从这里出来很多很浓的东西呢，小紫，小紫！光是想象一下，唾液就溢出来了，呜，呜，呜，呜！　
私の奉仕で、ご主人様に興奮してもらえると、んくっ、ぢゅるるぅ！　私まで興奮して、止められなくなる、ぢゅぱっ、じゅるっ、じゅるぅ！	因为我的服务，如果能让主人兴奋的话，嗯，真是的！连我都兴奋得停不下来了，小紫，小紫，小紫！
もしイってしまったら、口を離さないとダメか？　んちゅっ、ぢゅぶぅ！　もっと、長くしゃぶっていたいのに、んっちゅぱ、じゅるるぅ！　　	如果打中了，不放开嘴不行吗？嗯，是的！明明想再多吃一点，但是，嗯啾啾，好烦啊！　　
頭の中が、このことでいっぱいになってしまって、んちゅ、れるぅっ……、この匂いと、この味が、忘れられなかったんだ、ぁむ、っちゅ、ぢゅぱ……！	脑子里装满了这件事，嗯，嗯……我忘不了这个味道和这个味道。
んっふ、ぢゅぱ、ぢゅるぅ……！　下品な顔になってしまっても、仕方ないだろう、んちゅ、じゅぶぅ……！　この、太いのがいけないんだぞ……？	嗯，是啊，是啊……！就算脸上变得下流，也没办法啊，嗯，呜……！这个，粗的不行啊……？
口の中で、先走りと唾液が混じって、んちゅっ、じゅるる、じゅぶぅ！　興奮、してしまうんだ、んぐ、ぢゅる、ぢゅぱぁ！　	嘴里，混杂着抢先和唾液，嗯，嗯，嗯，嗯，呜，呜！好兴奋啊，好兴奋啊，好烫，好烫！　
ご主人様、まだイけないかっ？　れりゅっ、じゅるるぅ！　ご主人様の精液が、待ち遠しくて堪らないんだ、ぢゅぷっ、んぢゅるぅ！	主人，还不行吗？嘘，我知道了！我等不及主人的精液了，真是的，真是的！
イった後も、まだ、だからな？　っぢゅぱ、んっちゅ、んんぅ！　ご主人様が満足するまで、何回でも出させるから、ぢゅるるっ、じゅぶぅぅ！	回去之后，还是，所以呢？嗯，嗯，嗯！在主人满意之前，我会让他多次拿出来，咻咻，好的！
